#%%%e.r#####
p#.%####....
..e%#p##.##X
#.#%..#..#r.
###%#.#.##.#
##.e..e.##e#
pe.#...#...r
#..##..#e..r
##r###...#.#
#r###..###p#
..#.e.######
.....#######
