####.#r.#.p#
r###..#.#..#
.#..#.....##
..#...##..##
#.#...####r#
..#.#.e.r.e.
e...#.##..#.
.##.ep#pe.X.
r#r#####.##r
.e..##...###
e#e#.##.####
p#%..#######
