#####r.#####
####.#e####r
##%#%%%.ep#r
##%#%#%.#...
##%%%#%.....
##p.#%%.....
r###e%#r###p
..##.###eX##
..r#.....###
##..e###e###
#pe.####r###
##....######
