p#r...###r.#
.##...p#...#
.....e#....r
#..##...#..#
r###...##e.#
e.e..#....##
#.#.#pe##.##
#r#.##%%%%##
.e%%%%%#.%.r
..%######%..
.#%#########
%%%#########
