.%%#r##e...#
#%##.#..#pp#
#%%%%%%..###
....##%.####
....##%##r##
r##.##%.#...
#e###r%%%#e.
...###pe%%.#
##r...e##%.r
###.#####%%.
##.e..p#%#%#
r..#..##%%%#
