####.#r.#.p#
r###..#.#..#
.#..#.....##
..#...##..##
#.#...####r#
..#.#%%%%%e.
%%%%#%##.%#.
%##%%%#pe%%.
%#r#####.##r
%%%.##...###
e#%#.##.####
p#%..#######
