#%%%e.r#####
p#.%####%%%%
..e%#p##%##%
#.#%%%#%%#r.
###.#%#%##.#
##.e.%%%##e#
pe.#...#...r
#..##..#e..r
##r###...#.#
#r###..###p#
..#.e.######
.....#######
