p..e##.....#
###....###.r
.r..####p.e#
%.##r#r###..
%##..#.#.##.
%.##...#%%%.
%#r##%%%%#%#
%%%%#%###..#
#.#%%%#..r.#
.e...##...##
p.##.###.#X.
##p..#r....#
