p..e##.....#
###....###.r
.r..####p.e#
%.##r#r###..
%##..#.#.##.
%.##...#....
%#r##..e.#e#
%%%%#.###..#
#.#%..#..r.#
.e...##...##
p.##.###.#X.
##p..#r....#
