#####r.#####
####.#e####r
##%#%%%%%%#r
##%#%#..#%..
##%%%#...%..
##p.#%%%%%..
r###%%#r###p
..##%###%%##
..r#%%%%%###
##..e###e###
#pe.####r###
##....######
