####.#r.#.p#
r###..#.#..#
.#..#.....##
..#...##..##
#.#...####r#
..#.#%%.r.e.
%%%%#%##..#.
%##%%%#pe.X.
%#r#####.##r
%%%.##...###
e#%#.##.####
p#%..#######
